Rk,Player,Pos,Age,Tm,G,GS,MP,FG,FGA,FG%,3P,3PA,3P%,2P,2PA,2P%,eFG%,FT,FTA,FT%,ORB,DRB,TRB,AST,STL,BLK,TOV,PF,PTS
1,Precious Achiuwa,C,23,TOR,28,4,615,108,226,0.478,15,60,0.25,93,166,0.56,0.511,55,74,0.743,57,122,179,28,17,19,34,53,286
2,Steven Adams,C,29,MEM,42,42,1133,157,263,0.597,0,1,0,157,262,0.599,0.597,47,129,0.364,214,271,485,97,36,46,79,98,361
3,Bam Adebayo,C,25,MIA,47,47,1649,403,747,0.539,1,10,0.1,402,737,0.545,0.54,197,250,0.788,133,336,469,146,54,38,123,135,1004
4,Ochai Agbaji,SG,22,UTA,29,0,373,43,90,0.478,18,50,0.36,25,40,0.625,0.578,10,16,0.625,17,30,47,14,3,4,9,38,114
5,Santi Aldama,PF,22,MEM,47,16,1024,151,315,0.479,61,164,0.372,90,151,0.596,0.576,64,90,0.711,51,166,217,57,32,33,31,94,427
6,Nickeil Alexander-Walker,SG,24,UTA,35,3,523,83,168,0.494,35,87,0.402,48,81,0.593,0.598,27,39,0.692,8,51,59,76,24,14,44,57,228
7,Grayson Allen,SG,27,MIL,47,45,1288,161,363,0.444,90,224,0.402,71,139,0.511,0.567,86,95,0.905,42,123,165,122,41,10,53,72,498
8,Jarrett Allen,C,24,CLE,46,46,1522,265,417,0.635,1,8,0.125,264,409,0.645,0.637,112,157,0.713,136,309,445,75,39,54,68,101,643
9,Jose Alvarado,PG,24,NOP,51,9,1122,172,423,0.407,74,217,0.341,98,206,0.476,0.494,61,75,0.813,21,102,123,161,60,8,69,108,479
10,Kyle Anderson,PF,29,MIN,42,27,1122,131,265,0.494,27,61,0.443,104,204,0.51,0.545,68,87,0.782,31,165,196,175,51,37,62,99,357
11,Giannis Antetokounmpo,PF,28,MIL,40,40,1337,449,838,0.536,33,120,0.275,416,718,0.579,0.555,341,528,0.646,95,392,487,209,32,33,162,140,1272
12,Thanasis Antetokounmpo,SF,30,MIL,22,0,92,4,17,0.235,0,4,0,4,13,0.308,0.235,3,6,0.5,7,15,22,4,2,3,7,10,11
13,Cole Anthony,PG,22,ORL,33,3,847,138,317,0.435,38,114,0.333,100,203,0.493,0.495,82,92,0.891,17,134,151,135,21,17,52,85,396
14,OG Anunoby,SF,25,TOR,45,45,1611,282,617,0.457,86,235,0.366,196,382,0.513,0.527,110,134,0.821,68,180,248,91,93,35,98,133,760
15,Ryan Arcidiacono,PG,28,NYK,11,0,26,1,5,0.2,1,3,0.333,0,2,0,0.3,0,0,,0,4,4,2,2,0,1,3,3
16,Deni Avdija,SF,22,WAS,48,30,1256,151,344,0.439,40,140,0.286,111,204,0.544,0.497,74,98,0.755,52,248,300,120,40,26,69,143,416
17,Deandre Ayton,C,24,PHO,43,43,1285,333,584,0.57,7,23,0.304,326,561,0.581,0.576,91,127,0.717,124,311,435,91,21,29,90,122,764
18,Udoka Azubuike,C,23,UTA,18,0,71,14,17,0.824,0,0,,14,17,0.824,0.824,2,6,0.333,10,17,27,5,2,4,4,7,30
19,Marvin Bagley III,C,23,DET,25,13,532,108,201,0.537,9,33,0.273,99,168,0.589,0.56,40,52,0.769,52,96,148,14,13,18,22,51,265
20,Patrick Baldwin Jr.,SF,20,GSW,15,0,127,27,62,0.435,22,49,0.449,5,13,0.385,0.613,4,6,0.667,0,21,21,3,6,1,7,7,80
21,LaMelo Ball,PG,21,CHO,25,25,865,202,505,0.4,97,271,0.358,105,234,0.449,0.496,77,89,0.865,28,114,142,207,29,11,83,89,578
22,Mo Bamba,C,24,ORL,39,5,660,102,205,0.498,40,101,0.396,62,104,0.596,0.595,35,51,0.686,46,134,180,40,11,37,21,83,279
23,Paolo Banchero,PF,20,ORL,44,44,1483,294,679,0.433,60,190,0.316,234,489,0.479,0.477,261,342,0.763,45,237,282,161,45,21,124,102,909
24,Desmond Bane,SG,24,MEM,28,28,870,210,459,0.458,85,201,0.423,125,258,0.484,0.55,100,112,0.893,18,124,142,117,23,8,62,68,605
25,Dalano Banton,PG,23,TOR,22,2,222,44,104,0.423,13,43,0.302,31,61,0.508,0.486,14,17,0.824,9,23,32,26,12,12,13,24,115
26,Dominick Barlow,SF,19,SAS,4,0,26,3,7,0.429,0,3,0,3,4,0.75,0.429,4,4,1,2,1,3,3,1,0,0,3,10
27,Harrison Barnes,PF,30,SAC,49,49,1603,227,476,0.477,86,225,0.382,141,251,0.562,0.567,207,252,0.821,46,187,233,81,41,6,61,66,747
28,Scottie Barnes,PF,21,TOR,49,48,1706,300,645,0.465,41,141,0.291,259,504,0.514,0.497,127,165,0.77,112,235,347,242,51,43,100,101,768
29,RJ Barrett,SG,22,NYK,46,46,1589,324,748,0.433,85,250,0.34,239,498,0.48,0.49,193,255,0.757,39,208,247,128,22,8,104,110,926
30,Will Barton,SG,32,WAS,38,0,750,102,269,0.379,49,131,0.374,53,138,0.384,0.47,33,41,0.805,9,95,104,95,16,10,42,38,286
31,Charles Bassey,C,22,SAS,24,1,327,47,70,0.671,2,6,0.333,45,64,0.703,0.686,16,24,0.667,44,81,125,29,8,22,28,50,112
32,Keita Bates-Diop,SF,27,SAS,37,16,676,107,215,0.498,21,58,0.362,86,157,0.548,0.547,47,60,0.783,42,70,112,32,24,8,26,34,282
33,Nicolas Batum,PF,34,LAC,51,11,1119,106,252,0.421,80,204,0.392,26,48,0.542,0.579,24,36,0.667,46,171,217,74,31,36,37,107,316
34,Darius Bazley,PF,22,OKC,33,1,519,66,150,0.44,15,41,0.366,51,109,0.468,0.49,35,63,0.556,24,87,111,31,17,29,21,33,182
35,Bradley Beal,SG,29,WAS,30,30,985,248,484,0.512,46,127,0.362,202,357,0.566,0.56,118,139,0.849,24,81,105,156,25,19,80,53,660
36,Malik Beasley,SG,26,UTA,52,13,1405,255,636,0.401,161,445,0.362,94,191,0.492,0.528,37,44,0.841,27,158,185,88,43,8,56,69,708
37,MarJon Beauchamp,SF,22,MIL,34,9,506,73,183,0.399,35,107,0.327,38,76,0.5,0.495,18,25,0.72,32,49,81,23,15,2,33,53,199
38,Dāvis Bertāns,PF,30,DAL,33,0,355,44,108,0.407,34,94,0.362,10,14,0.714,0.565,10,12,0.833,5,25,30,12,7,3,9,39,132
39,Patrick Beverley,PG,34,LAL,42,42,1132,90,231,0.39,52,152,0.342,38,79,0.481,0.502,35,43,0.814,24,111,135,105,37,22,38,114,267
40,Saddiq Bey,SF,23,DET,48,30,1382,224,557,0.402,92,268,0.343,132,289,0.457,0.485,163,191,0.853,51,166,217,74,46,10,51,78,703
41,Khem Birch,C,30,TOR,20,0,162,19,32,0.594,1,2,0.5,18,30,0.6,0.609,4,5,0.8,8,17,25,7,5,5,8,24,43
42,Goga Bitadze,C,23,IND,21,0,202,27,52,0.519,4,14,0.286,23,38,0.605,0.558,11,24,0.458,25,24,49,18,9,10,12,34,69
43,Bismack Biyombo,C,30,PHO,42,9,600,74,133,0.556,0,0,,74,133,0.556,0.556,16,49,0.327,49,127,176,39,13,57,39,82,164
44,Buddy Boeheim,PG,23,DET,1,0,1,0,0,,0,0,,0,0,,,0,0,,0,0,0,0,0,0,0,0,0
45,Bogdan Bogdanović,SG,30,ATL,26,5,800,149,349,0.427,73,199,0.367,76,150,0.507,0.532,30,39,0.769,9,79,88,80,22,7,32,41,401
46,Bojan Bogdanović,PF,33,DET,49,49,1548,352,723,0.487,121,291,0.416,231,432,0.535,0.571,223,253,0.881,28,152,180,130,30,5,110,87,1048
47,Bol Bol,PF,23,ORL,46,32,1124,209,362,0.577,26,75,0.347,183,287,0.638,0.613,63,85,0.741,57,246,303,41,22,67,86,62,507
48,Leandro Bolmaro,SG,22,UTA,13,0,65,3,19,0.158,0,4,0,3,15,0.2,0.158,0,0,,3,2,5,7,3,1,7,8,6
49,Devin Booker,SG,26,PHO,29,29,1002,283,593,0.477,67,181,0.37,216,412,0.524,0.534,153,180,0.85,23,111,134,161,26,11,70,77,786
50,Brandon Boston Jr.,SG,21,LAC,19,0,218,42,108,0.389,11,28,0.393,31,80,0.388,0.44,26,34,0.765,7,20,27,19,8,0,11,19,121
51,Chris Boucher,PF,30,TOR,46,0,939,152,323,0.471,36,116,0.31,116,207,0.56,0.526,92,124,0.742,100,161,261,21,32,34,21,89,432
52,James Bouknight,SG,22,CHO,26,0,354,40,122,0.328,16,64,0.25,24,58,0.414,0.393,15,22,0.682,5,46,51,28,13,4,19,29,111
53,Tony Bradley,C,25,CHI,10,0,26,4,8,0.5,2,4,0.5,2,4,0.5,0.625,2,2,1,1,9,10,1,1,0,1,1,12
54,Malaki Branham,SF,19,SAS,37,5,729,103,250,0.412,33,119,0.277,70,131,0.534,0.478,25,31,0.806,10,55,65,64,18,4,37,51,264
55,Christian Braun,SG,21,DEN,46,2,632,68,145,0.469,16,47,0.34,52,98,0.531,0.524,16,27,0.593,29,65,94,26,14,10,19,50,168
56,Mikal Bridges,SF,26,PHO,52,52,1900,322,693,0.465,95,238,0.399,227,455,0.499,0.533,133,149,0.893,51,175,226,186,62,44,71,106,872
57,Oshae Brissett,SF,24,IND,45,1,739,81,204,0.397,36,109,0.33,45,95,0.474,0.485,60,86,0.698,42,111,153,25,27,8,21,60,258
58,Malcolm Brogdon,PG,30,BOS,43,0,1074,215,452,0.476,85,190,0.447,130,262,0.496,0.57,109,124,0.879,33,153,186,160,26,12,66,64,624
59,Dillon Brooks,SF,27,MEM,46,46,1408,271,688,0.394,88,277,0.318,183,411,0.445,0.458,86,110,0.782,29,130,159,123,38,8,73,154,716
60,Bruce Brown,SG,26,DEN,50,22,1439,220,449,0.49,67,170,0.394,153,279,0.548,0.565,49,68,0.721,38,167,205,179,53,35,84,120,556
61,Greg Brown III,PF,21,POR,15,0,89,11,26,0.423,1,6,0.167,10,20,0.5,0.442,5,12,0.417,2,16,18,1,4,5,6,13,28
62,Jaylen Brown,SF,26,BOS,45,45,1619,454,925,0.491,111,338,0.328,343,587,0.584,0.551,195,248,0.786,57,266,323,145,50,22,140,123,1214
63,Kendall Brown,SG,19,IND,6,0,40,4,7,0.571,0,1,0,4,6,0.667,0.571,1,2,0.5,2,4,6,3,4,0,2,9,9
64,Moses Brown,C,23,LAC,34,1,288,61,96,0.635,0,0,,61,96,0.635,0.635,33,72,0.458,57,82,139,4,3,14,14,38,155
65,Sterling Brown,SG,27,LAL,4,0,24,0,4,0,0,2,0,0,2,0,0,0,0,,3,5,8,2,3,0,0,4,0
66,Troy Brown Jr.,SF,23,LAL,46,28,1110,118,278,0.424,56,161,0.348,62,117,0.53,0.525,24,25,0.96,40,152,192,46,34,8,33,66,316
67,Jalen Brunson,PG,26,NYK,49,49,1697,403,860,0.469,86,218,0.394,317,642,0.494,0.519,226,265,0.853,31,139,170,304,47,14,102,115,1118
68,Thomas Bryant,C,25,LAL,38,25,844,190,292,0.651,21,47,0.447,169,245,0.69,0.687,78,104,0.75,65,202,267,28,14,21,28,77,479
69,Reggie Bullock,SF,31,DAL,50,30,1475,110,282,0.39,86,236,0.364,24,46,0.522,0.543,19,29,0.655,24,147,171,61,35,11,20,115,325
70,Alec Burks,SG,31,DET,39,3,867,162,356,0.455,78,175,0.446,84,181,0.464,0.565,125,154,0.812,14,107,121,87,29,5,43,77,527
71,Jimmy Butler,SF,33,MIA,37,37,1253,269,516,0.521,21,70,0.3,248,446,0.556,0.542,254,303,0.838,74,148,222,183,79,13,63,51,813
72,John Butler,C,20,POR,6,0,18,1,4,0.25,0,3,0,1,1,1,0.25,0,0,,1,1,2,1,0,1,0,1,2
73,Jamal Cain,SF,23,MIA,13,0,181,25,48,0.521,2,11,0.182,23,37,0.622,0.542,12,16,0.75,12,26,38,8,8,0,4,15,64
74,Kentavious Caldwell-Pope,SG,29,DEN,49,49,1551,198,423,0.468,101,218,0.463,97,205,0.473,0.587,62,75,0.827,24,123,147,110,69,18,55,104,559
75,Facundo Campazzo,PG,31,DAL,8,0,52,3,13,0.231,3,11,0.273,0,2,0,0.346,1,2,0.5,0,2,2,9,6,0,3,3,10
76,Vlatko Čančar,PF,25,DEN,36,1,510,63,128,0.492,30,66,0.455,33,62,0.532,0.609,16,17,0.941,16,60,76,44,13,8,25,60,172
77,Clint Capela,C,28,ATL,35,33,950,193,300,0.643,0,1,0,193,299,0.645,0.643,41,67,0.612,152,250,402,27,25,45,29,76,427
78,Vernon Carey Jr.,C,21,WAS,9,0,24,1,6,0.167,0,0,,1,6,0.167,0.167,2,2,1,3,5,8,2,2,2,2,4,4
79,Jevon Carter,PG,27,MIL,51,30,1177,139,332,0.419,76,188,0.404,63,144,0.438,0.533,22,27,0.815,23,106,129,135,55,23,60,104,376
80,Wendell Carter Jr.,C,23,ORL,32,29,959,179,342,0.523,39,109,0.358,140,233,0.601,0.58,88,114,0.772,65,210,275,85,12,21,71,95,485
81,Alex Caruso,PG,28,CHI,44,17,1077,86,192,0.448,38,95,0.4,48,97,0.495,0.547,40,52,0.769,26,106,132,146,76,31,57,109,250
82,Julian Champagnie,SF,21,PHI,2,0,7,0,2,0,0,1,0,0,1,0,0,0,0,,0,0,0,0,1,0,0,0,0
83,Justin Champagnie,SF,21,TOR,3,0,11,3,3,1,0,0,,3,3,1,1,0,0,,1,3,4,1,0,0,0,1,6
84,Kennedy Chandler,PG,20,MEM,23,0,220,26,66,0.394,2,14,0.143,24,52,0.462,0.409,5,11,0.455,6,24,30,46,10,5,16,13,59
85,Max Christie,SG,19,LAL,33,2,479,43,100,0.43,26,61,0.426,17,39,0.436,0.56,12,14,0.857,7,65,72,17,7,6,11,31,124
86,Josh Christopher,SG,21,HOU,32,1,269,45,110,0.409,5,33,0.152,40,77,0.519,0.432,16,21,0.762,10,25,35,22,7,6,24,19,111
87,Brandon Clarke,PF,26,MEM,44,6,867,187,280,0.668,1,6,0.167,186,274,0.679,0.67,87,120,0.725,67,174,241,52,29,32,49,110,462
88,Jordan Clarkson,SG,30,UTA,51,51,1657,384,853,0.45,135,386,0.35,249,467,0.533,0.529,163,198,0.823,58,144,202,217,29,11,150,100,1066
89,Nic Claxton,C,23,BRK,47,47,1383,272,367,0.741,0,2,0,272,365,0.745,0.741,71,151,0.47,117,303,420,75,33,126,60,133,615
90,Amir Coffey,SG,25,LAC,38,9,538,47,126,0.373,10,35,0.286,37,91,0.407,0.413,45,55,0.818,16,32,48,48,7,3,15,48,149
91,John Collins,PF,25,ATL,43,43,1358,229,446,0.513,36,139,0.259,193,307,0.629,0.554,87,111,0.784,52,279,331,55,30,52,58,148,581
92,Zach Collins,C,25,SAS,40,7,826,148,276,0.536,23,62,0.371,125,214,0.584,0.578,65,88,0.739,78,158,236,98,15,29,76,126,384
93,Mike Conley,PG,35,UTA,40,39,1183,137,350,0.391,74,202,0.366,63,148,0.426,0.497,64,80,0.8,17,84,101,303,43,8,64,88,412
94,Pat Connaughton,SG,30,MIL,35,19,871,105,274,0.383,73,209,0.349,32,65,0.492,0.516,16,27,0.593,28,140,168,44,24,4,20,37,299
95,Robert Covington,PF,32,LAC,33,0,540,65,158,0.411,32,95,0.337,33,63,0.524,0.513,25,34,0.735,23,105,128,43,23,26,23,61,187
96,Torrey Craig,SF,32,PHO,49,40,1252,152,333,0.456,65,164,0.396,87,169,0.515,0.554,26,33,0.788,98,180,278,75,35,30,44,116,395
97,Jarrett Culver,SG,23,ATL,10,1,137,17,43,0.395,1,12,0.083,16,31,0.516,0.407,9,13,0.692,10,28,38,6,6,2,7,14,44
98,Cade Cunningham,PG,21,DET,12,12,400,93,224,0.415,17,61,0.279,76,163,0.466,0.453,36,43,0.837,12,62,74,72,10,7,39,34,239
99,Seth Curry,SG,32,BRK,37,4,860,147,315,0.467,70,165,0.424,77,150,0.513,0.578,34,35,0.971,10,67,77,79,23,7,41,70,398
100,Stephen Curry,PG,34,GSW,35,35,1212,347,702,0.494,173,405,0.427,174,297,0.586,0.618,174,189,0.921,20,200,220,229,36,14,112,71,1041
101,Dyson Daniels,PG,19,NOP,39,11,778,69,155,0.445,20,60,0.333,49,95,0.516,0.51,18,29,0.621,28,110,138,96,34,10,43,75,176
102,Anthony Davis,C,29,LAL,28,26,933,277,475,0.583,11,38,0.289,266,437,0.609,0.595,184,223,0.825,90,243,333,72,36,57,57,77,749
103,Johnny Davis,SG,20,WAS,10,0,50,4,13,0.308,0,3,0,4,10,0.4,0.308,3,3,1,1,6,7,2,0,1,1,12,11
104,Terence Davis,SG,25,SAC,36,4,463,83,198,0.419,45,130,0.346,38,68,0.559,0.533,23,26,0.885,15,71,86,45,27,9,31,62,234
105,JD Davison,PG,20,BOS,5,0,12,1,5,0.2,0,2,0,1,3,0.333,0.2,0,0,,0,2,2,1,1,0,1,0,2
106,Dewayne Dedmon,C,33,MIA,29,0,338,64,125,0.512,11,36,0.306,53,89,0.596,0.556,32,44,0.727,28,79,107,15,6,13,19,58,171
107,Matthew Dellavedova,PG,32,SAC,20,0,115,10,26,0.385,5,12,0.417,5,14,0.357,0.481,1,3,0.333,1,6,7,24,6,0,6,12,26
108,DeMar DeRozan,SF,33,CHI,47,47,1702,443,867,0.511,22,70,0.314,421,797,0.528,0.524,326,368,0.886,22,206,228,233,48,23,100,128,1234
109,Moussa Diabaté,PF,21,LAC,14,1,162,20,39,0.513,1,2,0.5,19,37,0.514,0.526,10,16,0.625,28,16,44,3,5,5,8,13,51
110,Mamadi Diakite,PF,26,CLE,14,2,92,11,25,0.44,4,14,0.286,7,11,0.636,0.52,0,0,,3,8,11,2,2,5,6,11,26
111,Hamidou Diallo,SG,24,DET,43,0,718,145,252,0.575,5,18,0.278,140,234,0.598,0.585,67,115,0.583,44,105,149,42,40,11,50,93,362
112,Gorgui Dieng,C,33,SAS,17,1,166,22,54,0.407,10,36,0.278,12,18,0.667,0.5,3,4,0.75,16,32,48,27,1,7,14,24,57
113,Ousmane Dieng,SF,19,OKC,17,0,247,28,64,0.438,11,37,0.297,17,27,0.63,0.523,1,4,0.25,8,36,44,22,5,4,9,17,68
114,Spencer Dinwiddie,PG,29,DAL,51,51,1740,303,658,0.46,133,329,0.404,170,329,0.517,0.562,155,190,0.816,18,138,156,271,37,14,84,119,894
115,Donte DiVincenzo,SG,26,GSW,40,12,1000,114,279,0.409,74,189,0.392,40,90,0.444,0.541,30,37,0.811,39,144,183,132,52,4,55,74,332
116,Luka Dončić,PG,23,DAL,46,46,1691,517,1031,0.501,128,361,0.355,389,670,0.581,0.564,376,515,0.73,42,366,408,383,69,24,167,128,1538
117,Tyler Dorsey,SG,26,DAL,3,0,8,4,5,0.8,1,2,0.5,3,3,1,0.9,0,0,,1,1,2,0,0,0,0,0,9
118,Luguentz Dort,SG,23,OKC,47,47,1426,226,556,0.406,90,252,0.357,136,304,0.447,0.487,119,157,0.758,66,133,199,107,49,12,67,153,661
119,Ayo Dosunmu,SG,23,CHI,48,40,1319,182,361,0.504,40,126,0.317,142,235,0.604,0.56,44,57,0.772,33,116,149,128,34,17,66,121,448
120,Devon Dotson,PG,23,WAS,6,0,53,1,10,0.1,1,4,0.25,0,6,0,0.15,0,0,,6,4,10,8,5,0,3,9,3
121,Jeff Dowtin,PG,25,TOR,14,0,93,12,25,0.48,1,4,0.25,11,21,0.524,0.5,3,3,1,5,8,13,12,2,1,2,5,28
122,PJ Dozier,SG,26,SAC,4,0,10,2,3,0.667,1,2,0.5,1,1,1,0.833,0,0,,0,2,2,0,3,0,0,0,5
123,Goran Dragić,PG,36,CHI,44,0,705,121,281,0.431,43,118,0.364,78,163,0.479,0.507,25,39,0.641,12,53,65,123,9,4,49,60,310
124,Andre Drummond,C,29,CHI,37,0,473,94,154,0.61,0,2,0,94,152,0.618,0.61,35,66,0.53,80,162,242,23,22,11,37,71,223
125,Chris Duarte,SF,25,IND,31,10,600,82,227,0.361,36,120,0.3,46,107,0.43,0.441,50,59,0.847,10,65,75,49,14,8,27,45,250
126,David Duke Jr.,SG,23,BRK,14,0,126,19,43,0.442,0,6,0,19,37,0.514,0.442,4,8,0.5,6,9,15,12,5,1,13,23,42
127,Kevin Durant,PF,34,BRK,39,39,1403,410,734,0.559,71,189,0.376,339,545,0.622,0.607,267,286,0.934,14,248,262,207,32,57,136,92,1158
128,Jalen Duren,C,19,DET,44,19,1079,155,235,0.66,0,1,0,155,234,0.662,0.66,58,93,0.624,147,228,375,43,29,37,50,114,368
129,Tari Eason,PF,21,HOU,50,3,968,165,370,0.446,36,100,0.36,129,270,0.478,0.495,56,72,0.778,109,169,278,49,54,29,53,106,422
130,Anthony Edwards,SG,21,MIN,53,53,1937,474,1019,0.465,148,393,0.377,326,626,0.521,0.538,223,291,0.766,35,288,323,241,90,32,179,135,1319
131,Kessler Edwards,SF,22,BRK,13,1,74,6,22,0.273,2,11,0.182,4,11,0.364,0.318,1,2,0.5,6,8,14,2,3,1,4,3,15
132,Keon Ellis,SG,23,SAC,5,0,11,1,2,0.5,1,2,0.5,0,0,,0.75,0,0,,0,2,2,1,0,0,0,2,3
133,Joel Embiid,C,28,PHI,37,37,1288,417,781,0.534,44,123,0.358,373,658,0.567,0.562,367,431,0.852,68,303,371,155,42,62,138,125,1245
134,Drew Eubanks,C,25,POR,48,6,903,113,158,0.715,3,6,0.5,110,152,0.724,0.725,41,62,0.661,70,148,218,48,24,58,37,97,270
135,Bruno Fernando,C,24,HOU,26,4,299,39,73,0.534,0,1,0,39,72,0.542,0.534,22,34,0.647,37,56,93,25,6,22,15,56,100
136,Dorian Finney-Smith,PF,29,DAL,38,38,1220,119,291,0.409,71,205,0.346,48,86,0.558,0.531,25,34,0.735,60,112,172,53,36,19,34,74,334
137,Malachi Flynn,PG,24,TOR,35,1,495,64,175,0.366,37,98,0.378,27,77,0.351,0.471,13,17,0.765,13,42,55,50,11,3,16,50,178
138,Simone Fontecchio,SF,27,UTA,26,0,211,30,79,0.38,21,57,0.368,9,22,0.409,0.513,9,14,0.643,11,17,28,8,3,5,14,22,90
139,Bryn Forbes,SG,29,MIN,22,0,235,25,74,0.338,10,39,0.256,15,35,0.429,0.405,13,13,1,4,9,13,14,7,1,9,19,73
140,Trent Forrest,PG,24,ATL,16,3,220,23,47,0.489,0,2,0,23,45,0.511,0.489,2,3,0.667,5,23,28,31,6,2,9,16,48
141,Michael Foster Jr.,PF,20,PHI,1,0,1,0,0,,0,0,,0,0,,,0,0,,0,0,0,0,0,0,0,0,0
142,Evan Fournier,SG,30,NYK,20,7,370,46,132,0.348,27,87,0.31,19,45,0.422,0.451,16,19,0.842,4,38,42,30,12,3,19,35,135
143,De'Aaron Fox,PG,25,SAC,46,46,1546,417,827,0.504,73,222,0.329,344,605,0.569,0.548,202,257,0.786,19,179,198,279,45,15,118,113,1109
144,Markelle Fultz,PG,24,ORL,30,30,841,150,306,0.49,13,38,0.342,137,268,0.511,0.511,49,69,0.71,31,82,113,172,45,12,70,59,362
145,Wenyen Gabriel,PF,25,LAL,41,2,642,112,181,0.619,9,27,0.333,103,154,0.669,0.644,35,55,0.636,67,98,165,19,15,25,29,91,268
146,Daniel Gafford,C,24,WAS,48,17,850,161,217,0.742,0,0,,161,217,0.742,0.742,74,118,0.627,97,149,246,37,17,60,44,108,396
147,Darius Garland,PG,23,CLE,44,44,1565,328,725,0.452,109,273,0.399,219,452,0.485,0.528,192,221,0.869,20,104,124,357,58,5,128,89,957
148,Usman Garuba,PF,20,HOU,46,1,638,56,107,0.523,11,24,0.458,45,83,0.542,0.575,19,36,0.528,81,135,216,45,30,23,32,79,142
149,Luka Garza,C,24,MIN,17,0,135,31,63,0.492,7,22,0.318,24,41,0.585,0.548,22,27,0.815,15,16,31,6,2,1,6,25,91
150,Rudy Gay,PF,36,UTA,37,0,546,60,166,0.361,20,84,0.238,40,82,0.488,0.422,22,27,0.815,23,90,113,32,15,13,21,46,162
151,Paul George,SG,32,LAC,37,37,1260,300,647,0.464,109,283,0.385,191,364,0.525,0.548,154,174,0.885,27,199,226,198,55,15,125,99,863
152,Taj Gibson,C,37,WAS,32,2,324,46,85,0.541,3,15,0.2,43,70,0.614,0.559,20,29,0.69,24,39,63,26,12,8,19,65,115
153,Josh Giddey,SG,20,OKC,45,45,1388,313,646,0.485,44,135,0.326,269,511,0.526,0.519,56,72,0.778,87,272,359,257,32,21,139,95,726
154,Shai Gilgeous-Alexander,PG,24,OKC,46,46,1639,476,933,0.51,46,125,0.368,430,808,0.532,0.535,424,467,0.908,38,181,219,260,76,52,137,119,1422
155,Anthony Gill,PF,30,WAS,36,4,354,43,72,0.597,2,17,0.118,41,55,0.745,0.611,20,24,0.833,19,32,51,17,5,5,5,45,108
156,Rudy Gobert,C,30,MIN,44,44,1366,224,332,0.675,0,3,0,224,329,0.681,0.675,141,212,0.665,142,375,517,39,37,58,78,131,589
157,Jordan Goodwin,PG,24,WAS,36,4,678,92,201,0.458,26,64,0.406,66,137,0.482,0.522,30,40,0.75,34,90,124,97,38,19,34,63,240
158,Aaron Gordon,PF,27,DEN,46,46,1389,293,508,0.577,45,116,0.388,248,392,0.633,0.621,141,228,0.618,113,201,314,125,35,35,74,88,772
159,Eric Gordon,SG,34,HOU,43,43,1287,184,432,0.426,76,226,0.336,108,206,0.524,0.514,93,113,0.823,12,78,90,116,24,15,71,38,537
160,Devonte' Graham,PG,27,NOP,52,0,796,83,226,0.367,64,185,0.346,19,41,0.463,0.509,44,59,0.746,12,60,72,113,30,10,27,46,274
161,Jerami Grant,PF,28,POR,48,48,1718,351,720,0.488,116,275,0.422,235,445,0.528,0.568,204,256,0.797,45,162,207,114,42,39,86,114,1022
162,A.J. Green,SG,23,MIL,24,0,219,37,84,0.44,28,70,0.4,9,14,0.643,0.607,4,4,1,4,22,26,11,5,0,7,23,106
163,Draymond Green,PF,32,GSW,45,45,1421,139,270,0.515,27,83,0.325,112,187,0.599,0.565,50,70,0.714,37,294,331,311,41,35,112,135,355
164,Jalen Green,SG,20,HOU,48,48,1660,351,853,0.411,120,363,0.331,231,490,0.471,0.482,220,282,0.78,28,171,199,176,35,10,141,81,1042
165,JaMychal Green,PF,32,GSW,31,1,460,73,143,0.51,17,57,0.298,56,86,0.651,0.57,28,36,0.778,47,81,128,22,14,10,36,62,191
166,Javonte Green,SG,29,CHI,28,1,449,61,104,0.587,13,34,0.382,48,70,0.686,0.649,29,43,0.674,25,57,82,23,22,20,20,47,164
167,Jeff Green,PF,36,DEN,30,3,585,85,164,0.518,12,43,0.279,73,121,0.603,0.555,45,66,0.682,23,54,77,37,13,7,28,58,227
168,Josh Green,SG,22,DAL,32,2,715,85,153,0.556,32,74,0.432,53,79,0.671,0.66,45,62,0.726,30,47,77,45,28,2,29,81,247
169,AJ Griffin,SF,19,ATL,47,10,980,179,368,0.486,78,191,0.408,101,177,0.571,0.592,22,24,0.917,22,78,100,48,37,6,30,56,458
170,Blake Griffin,C,33,BOS,20,9,267,30,61,0.492,9,27,0.333,21,34,0.618,0.566,15,21,0.714,16,50,66,22,6,3,6,35,84
171,Quentin Grimes,SG,22,NYK,41,36,1237,149,335,0.445,77,220,0.35,72,115,0.626,0.56,47,58,0.81,35,107,142,84,30,17,45,106,422
172,Rui Hachimura,PF,24,TOT,34,2,841,179,364,0.492,34,102,0.333,145,262,0.553,0.538,51,72,0.708,25,126,151,38,12,13,37,44,443
172,Rui Hachimura,PF,24,WAS,30,0,728,158,324,0.488,30,89,0.337,128,235,0.545,0.534,44,58,0.759,19,109,128,35,11,12,36,39,390
172,Rui Hachimura,PF,24,LAL,4,2,113,21,40,0.525,4,13,0.308,17,27,0.63,0.575,7,14,0.5,6,17,23,3,1,1,1,5,53
173,Tyrese Haliburton,PG,22,IND,40,40,1336,290,604,0.48,118,296,0.399,172,308,0.558,0.578,110,125,0.88,27,132,159,409,70,16,105,44,808
174,Jordan Hall,SF,21,SAS,9,0,83,9,28,0.321,3,15,0.2,6,13,0.462,0.375,7,9,0.778,3,9,12,11,1,0,7,6,28
175,R.J. Hampton,PG,21,ORL,26,0,361,50,114,0.439,18,53,0.34,32,61,0.525,0.518,31,37,0.838,9,30,39,34,16,4,21,22,149
176,Tim Hardaway Jr.,SG,30,DAL,48,31,1436,219,574,0.382,131,373,0.351,88,201,0.438,0.496,85,112,0.759,18,148,166,75,38,7,42,80,654
177,James Harden,PG,33,PHI,33,33,1212,215,481,0.447,93,241,0.386,122,240,0.508,0.544,179,207,0.865,18,191,209,363,40,18,114,72,702
178,Jaden Hardy,SG,20,DAL,23,0,229,45,112,0.402,12,44,0.273,33,68,0.485,0.455,25,30,0.833,1,27,28,13,5,3,14,29,127
179,Ron Harper Jr.,SF,22,TOR,3,0,9,3,5,0.6,2,3,0.667,1,2,0.5,0.8,0,0,,1,1,2,0,0,0,0,0,8
180,Montrezl Harrell,C,29,PHI,45,7,583,105,174,0.603,0,2,0,105,172,0.61,0.603,59,85,0.694,55,69,124,29,15,24,30,68,269
181,Gary Harris,SG,28,ORL,23,17,549,75,148,0.507,41,88,0.466,34,60,0.567,0.645,18,21,0.857,11,35,46,28,18,5,19,48,209
182,Joe Harris,SG,31,BRK,43,28,1056,133,294,0.452,81,203,0.399,52,91,0.571,0.59,14,21,0.667,16,102,118,68,24,12,28,112,361
183,Kevon Harris,SG,25,ORL,26,0,328,32,76,0.421,11,28,0.393,21,48,0.438,0.493,22,27,0.815,22,30,52,12,12,3,16,35,97
184,Tobias Harris,PF,30,PHI,45,45,1519,291,578,0.503,83,219,0.379,208,359,0.579,0.575,68,79,0.861,46,232,278,119,47,24,61,97,733
185,Josh Hart,SF,27,POR,47,47,1574,164,325,0.505,31,96,0.323,133,229,0.581,0.552,80,110,0.727,89,297,386,191,51,9,75,126,439
186,Isaiah Hartenstein,C,24,NYK,52,7,983,113,223,0.507,8,34,0.235,105,189,0.556,0.525,35,45,0.778,141,181,322,43,29,39,40,121,269
187,Udonis Haslem,C,42,MIA,5,1,36,1,10,0.1,0,1,0,1,9,0.111,0.1,1,2,0.5,3,3,6,0,1,1,0,7,3
188,Sam Hauser,PF,25,BOS,49,0,714,95,219,0.434,72,184,0.391,23,35,0.657,0.598,10,15,0.667,20,96,116,34,14,11,15,56,272
189,Jaxson Hayes,C,22,NOP,29,2,410,54,101,0.535,3,23,0.13,51,78,0.654,0.55,39,58,0.672,26,61,87,24,8,11,18,44,150
190,Killian Hayes,PG,21,DET,48,32,1278,190,493,0.385,58,182,0.319,132,311,0.424,0.444,37,47,0.787,18,116,134,277,63,16,95,141,475
191,Gordon Hayward,SF,32,CHO,26,26,813,134,298,0.45,28,91,0.308,106,207,0.512,0.497,64,80,0.8,22,97,119,96,21,7,51,29,360
192,Juancho Hernangómez,PF,27,TOR,39,10,600,48,111,0.432,17,64,0.266,31,47,0.66,0.509,9,16,0.563,26,94,120,24,16,6,15,43,122
193,Willy Hernangómez,C,28,NOP,26,0,327,63,117,0.538,1,7,0.143,62,110,0.564,0.543,55,72,0.764,44,75,119,23,9,11,27,44,182
194,Tyler Herro,SG,23,MIA,40,40,1393,292,668,0.437,121,325,0.372,171,343,0.499,0.528,104,113,0.92,18,213,231,173,36,11,98,65,809
195,Buddy Hield,SF,30,IND,52,52,1668,320,711,0.45,197,463,0.425,123,248,0.496,0.589,70,81,0.864,40,215,255,143,59,17,99,102,907
196,Haywood Highsmith,SF,26,MIA,36,9,683,66,159,0.415,29,80,0.363,37,79,0.468,0.506,7,18,0.389,40,98,138,25,29,10,29,53,168
197,George Hill,PG,36,MIL,34,0,667,59,132,0.447,23,74,0.311,36,58,0.621,0.534,34,46,0.739,13,54,67,89,19,3,27,41,175
198,Malcolm Hill,SF,27,CHI,4,0,2,0,0,,0,0,,0,0,,,0,0,,0,1,1,0,0,0,0,0,0
199,Aaron Holiday,PG,26,ATL,46,5,701,75,177,0.424,30,70,0.429,45,107,0.421,0.508,24,28,0.857,19,41,60,63,27,10,26,67,204
200,Jrue Holiday,PG,32,MIL,40,38,1312,293,635,0.461,90,244,0.369,203,391,0.519,0.532,99,116,0.853,55,155,210,289,54,17,127,77,775
201,Justin Holiday,SG,33,ATL,27,0,405,46,122,0.377,29,85,0.341,17,37,0.459,0.496,0,0,,2,21,23,24,5,10,12,36,121
202,Richaun Holmes,C,29,SAC,32,1,291,45,65,0.692,3,4,0.75,42,61,0.689,0.715,12,14,0.857,23,46,69,5,3,10,12,42,105
203,Al Horford,C,36,BOS,40,40,1235,142,300,0.473,81,192,0.422,61,108,0.565,0.608,10,14,0.714,47,197,244,107,22,40,23,77,375
204,Talen Horton-Tucker,SG,22,UTA,41,1,631,106,263,0.403,27,106,0.255,79,157,0.503,0.454,44,60,0.733,16,79,95,97,27,13,48,58,283
205,Danuel House Jr.,SF,29,PHI,34,2,532,55,116,0.474,24,69,0.348,31,47,0.66,0.578,27,36,0.75,7,56,63,25,6,7,16,42,161
206,Caleb Houstan,SF,20,ORL,30,2,496,40,105,0.381,28,77,0.364,12,28,0.429,0.514,11,13,0.846,21,48,69,18,5,3,10,43,119
207,Trevor Hudgins,PG,23,HOU,1,0,4,1,1,1,1,1,1,0,0,,1.5,0,0,,0,0,0,0,0,0,0,0,3
208,Kevin Huerter,SG,24,SAC,46,46,1421,255,533,0.478,129,316,0.408,126,217,0.581,0.599,64,90,0.711,28,130,158,139,50,13,67,116,703
209,De'Andre Hunter,SF,25,ATL,41,41,1315,228,504,0.452,66,182,0.363,162,322,0.503,0.518,119,142,0.838,25,152,177,54,20,8,52,126,641
210,Bones Hyland,PG,22,DEN,42,1,820,173,434,0.399,91,241,0.378,82,193,0.425,0.503,71,82,0.866,10,76,86,125,28,13,67,66,508
211,Serge Ibaka,C,33,MIL,16,0,185,26,54,0.481,6,18,0.333,20,36,0.556,0.537,8,13,0.615,15,29,44,4,2,7,11,23,66
212,Andre Iguodala,SF,39,GSW,3,0,42,3,4,0.75,1,2,0.5,2,2,1,0.875,0,0,,1,6,7,5,1,1,5,5,7
213,Joe Ingles,SF,35,MIL,19,0,419,44,106,0.415,32,83,0.386,12,23,0.522,0.566,11,13,0.846,7,37,44,65,12,3,26,30,131
214,Brandon Ingram,SF,25,NOP,18,18,568,126,288,0.438,30,75,0.4,96,213,0.451,0.49,81,92,0.88,8,83,91,88,16,11,56,41,363
215,Kyrie Irving,PG,30,BRK,39,39,1447,389,801,0.486,129,341,0.378,260,460,0.565,0.566,157,178,0.882,38,162,200,207,41,32,88,107,1064
216,Jonathan Isaac,PF,25,ORL,4,0,36,9,20,0.45,4,9,0.444,5,11,0.455,0.55,0,2,0,3,8,11,3,6,0,0,2,22
217,Jaden Ivey,SG,20,DET,48,47,1441,248,597,0.415,63,198,0.318,185,399,0.464,0.468,166,229,0.725,48,149,197,215,45,12,139,147,725
218,Isaiah Jackson,C,21,IND,39,5,610,104,187,0.556,1,9,0.111,103,178,0.579,0.559,60,88,0.682,55,98,153,35,17,57,36,89,269
219,Jaren Jackson Jr.,C,23,MEM,34,34,911,197,397,0.496,53,143,0.371,144,254,0.567,0.563,114,146,0.781,65,162,227,30,35,108,53,112,561
220,Justin Jackson,SF,27,BOS,21,0,99,6,25,0.24,5,19,0.263,1,6,0.167,0.34,1,2,0.5,2,12,14,8,4,4,2,7,18
221,Reggie Jackson,PG,32,LAC,48,38,1255,201,481,0.418,72,205,0.351,129,276,0.467,0.493,61,66,0.924,20,88,108,172,34,4,91,85,535
222,LeBron James,PF,38,LAL,41,41,1496,476,943,0.505,90,290,0.31,386,653,0.591,0.552,195,255,0.765,49,301,350,293,40,24,129,66,1237
223,Ty Jerome,SG,25,GSW,29,2,511,77,153,0.503,25,60,0.417,52,93,0.559,0.585,26,27,0.963,3,42,45,74,12,3,19,43,205
224,Isaiah Joe,SG,23,OKC,42,1,628,107,229,0.467,82,185,0.443,25,44,0.568,0.646,36,44,0.818,15,77,92,42,25,5,17,62,332
225,Alize Johnson,PF,26,SAS,4,0,30,3,6,0.5,0,2,0,3,4,0.75,0.5,1,2,0.5,2,8,10,1,1,0,4,3,7
226,Cameron Johnson,PF,26,PHO,14,13,362,67,146,0.459,39,88,0.443,28,58,0.483,0.592,23,29,0.793,12,45,57,22,12,6,6,26,196
227,Jalen Johnson,SF,21,ATL,47,6,681,92,194,0.474,20,71,0.282,72,123,0.585,0.526,38,55,0.691,31,139,170,44,22,21,22,71,242
228,James Johnson,PF,35,IND,12,1,98,10,27,0.37,3,10,0.3,7,17,0.412,0.426,3,4,0.75,2,14,16,7,4,5,5,24,26
229,Keldon Johnson,SF,23,SAS,45,45,1462,351,802,0.438,108,318,0.34,243,484,0.502,0.505,176,228,0.772,39,175,214,117,32,9,90,87,986
230,Keon Johnson,SG,20,POR,25,0,263,41,112,0.366,19,54,0.352,22,58,0.379,0.451,9,17,0.529,7,27,34,24,12,4,27,27,110
231,Stanley Johnson,SF,26,SAS,24,0,347,51,96,0.531,16,36,0.444,35,60,0.583,0.615,20,32,0.625,17,56,73,57,9,6,27,39,138
232,Nikola Jokić,C,27,DEN,44,44,1479,419,664,0.631,40,103,0.388,379,561,0.676,0.661,227,275,0.825,89,398,487,439,60,27,156,121,1105
233,Carlik Jones,PG,25,CHI,1,0,1,1,1,1,0,0,,1,1,1,1,0,0,,0,0,0,0,0,0,0,0,2
234,Damian Jones,C,27,LAL,22,1,176,20,37,0.541,0,3,0,20,34,0.588,0.541,15,20,0.75,18,37,55,4,3,12,9,17,55
235,Derrick Jones Jr.,SF,25,CHI,39,0,605,82,155,0.529,16,47,0.34,66,108,0.611,0.581,44,56,0.786,38,64,102,27,16,28,19,64,224
236,Herbert Jones,SF,24,NOP,36,36,1007,124,281,0.441,29,98,0.296,95,183,0.519,0.493,83,109,0.761,50,87,137,76,57,24,45,119,360
237,Kai Jones,C,22,CHO,27,0,237,31,59,0.525,3,11,0.273,28,48,0.583,0.551,8,12,0.667,20,32,52,5,5,11,9,30,73
238,Tre Jones,PG,23,SAS,50,50,1491,254,581,0.437,35,131,0.267,219,450,0.487,0.467,112,126,0.889,40,140,180,318,67,8,88,75,655
239,Tyus Jones,PG,26,MEM,50,8,1181,198,451,0.439,80,206,0.388,118,245,0.482,0.528,52,65,0.8,20,93,113,236,53,2,43,20,528
240,DeAndre Jordan,C,34,DEN,32,4,461,67,87,0.77,1,1,1,66,86,0.767,0.776,17,38,0.447,39,118,157,30,7,20,37,59,152
241,Cory Joseph,PG,31,DET,36,2,564,60,155,0.387,21,68,0.309,39,87,0.448,0.455,26,34,0.765,10,38,48,117,15,3,25,52,167
242,Nikola Jović,PF,19,MIA,15,8,204,28,69,0.406,8,35,0.229,20,34,0.588,0.464,18,19,0.947,9,22,31,10,7,2,10,19,82
243,Mfiondu Kabengele,PF,25,BOS,2,0,14,1,2,0.5,0,1,0,1,1,1,0.5,0,0,,3,2,5,0,0,0,1,3,2
244,Frank Kaminsky,C,29,ATL,24,0,168,24,42,0.571,11,23,0.478,13,19,0.684,0.702,10,12,0.833,3,33,36,20,4,1,8,19,69
245,Trevor Keels,SG,19,NYK,1,0,1,0,1,0,0,1,0,0,0,,0,0,0,,0,1,1,0,0,0,0,0,0
246,Luke Kennard,SG,26,LAC,33,11,704,97,204,0.475,58,128,0.453,39,76,0.513,0.618,19,20,0.95,6,77,83,37,18,4,30,46,271
247,Walker Kessler,C,21,UTA,49,15,988,163,228,0.715,0,0,,163,228,0.715,0.715,51,95,0.537,136,221,357,38,16,96,37,112,377
248,Braxton Key,SF,25,DET,3,0,9,1,1,1,0,0,,1,1,1,1,2,2,1,0,1,1,0,0,0,0,0,4
249,Corey Kispert,SF,23,WAS,42,28,1153,139,292,0.476,79,188,0.42,60,104,0.577,0.611,47,55,0.855,19,99,118,59,26,5,33,58,404
250,Maxi Kleber,C,31,DAL,22,0,564,51,104,0.49,24,65,0.369,27,39,0.692,0.606,11,14,0.786,19,59,78,21,7,22,13,48,137
251,Nathan Knight,PF,25,MIN,28,0,209,37,61,0.607,7,17,0.412,30,44,0.682,0.664,27,39,0.692,17,25,42,9,8,3,14,30,108
252,Kevin Knox,PF,23,DET,40,1,582,84,176,0.477,43,113,0.381,41,63,0.651,0.599,26,33,0.788,19,86,105,15,13,11,31,71,237
253,Christian Koloko,C,22,TOR,42,19,628,59,119,0.496,1,9,0.111,58,110,0.527,0.5,35,53,0.66,67,69,136,20,10,45,18,105,154
254,John Konchar,SG,26,MEM,43,22,997,102,234,0.436,47,129,0.364,55,105,0.524,0.536,20,23,0.87,41,171,212,63,47,11,25,65,271
255,Furkan Korkmaz,SG,25,PHI,24,0,253,32,78,0.41,12,35,0.343,20,43,0.465,0.487,19,29,0.655,6,23,29,18,6,3,15,10,95
256,Luke Kornet,C,27,BOS,44,0,513,70,103,0.68,3,9,0.333,67,94,0.713,0.694,20,24,0.833,58,74,132,29,8,34,16,57,163
257,Vit Krejci,PG,22,ATL,18,0,108,10,26,0.385,5,17,0.294,5,9,0.556,0.481,1,2,0.5,2,9,11,10,2,1,3,10,26
258,Jonathan Kuminga,PF,20,GSW,38,6,725,119,241,0.494,23,74,0.311,96,167,0.575,0.541,50,76,0.658,38,80,118,68,17,17,55,91,311
259,Kyle Kuzma,PF,27,WAS,49,49,1733,407,890,0.457,126,374,0.337,281,516,0.545,0.528,130,184,0.707,47,326,373,193,25,23,147,117,1070
260,Anthony Lamb,SF,25,GSW,41,3,804,109,215,0.507,57,141,0.404,52,74,0.703,0.64,27,36,0.75,33,104,137,69,22,11,42,96,302
261,Jock Landale,C,27,PHO,43,2,624,110,211,0.521,17,64,0.266,93,147,0.633,0.562,57,68,0.838,71,97,168,39,11,22,41,80,294
262,Romeo Langford,SG,23,SAS,32,19,646,100,204,0.49,13,46,0.283,87,158,0.551,0.522,24,37,0.649,46,46,92,43,16,11,22,55,237
263,Jake LaRavia,PF,21,MEM,28,0,373,34,84,0.405,21,60,0.35,13,24,0.542,0.53,7,9,0.778,16,42,58,21,12,4,17,43,96
264,Zach LaVine,SG,27,CHI,46,46,1647,382,829,0.461,132,350,0.377,250,479,0.522,0.54,193,231,0.835,27,196,223,194,46,8,116,101,1089
265,A.J. Lawson,SG,22,TOT,10,0,27,6,12,0.5,3,7,0.429,3,5,0.6,0.625,1,3,0.333,0,4,4,1,0,0,0,3,16
265,A.J. Lawson,SG,22,MIN,1,0,2,1,1,1,0,0,,1,1,1,1,0,0,,0,1,1,0,0,0,0,1,2
265,A.J. Lawson,SG,22,DAL,9,0,25,5,11,0.455,3,7,0.429,2,4,0.5,0.591,1,3,0.333,0,3,3,1,0,0,0,2,14
266,Damion Lee,SG,30,PHO,52,4,1159,154,337,0.457,91,193,0.472,63,144,0.438,0.592,74,82,0.902,26,146,172,76,22,5,59,84,473
267,Saben Lee,PG,23,TOT,12,0,183,23,48,0.479,6,13,0.462,17,35,0.486,0.542,24,31,0.774,7,15,22,35,3,1,14,13,76
267,Saben Lee,PG,23,PHI,2,0,10,3,4,0.75,0,1,0,3,3,1,0.75,0,0,,0,0,0,2,1,0,3,1,6
267,Saben Lee,PG,23,PHO,10,0,173,20,44,0.455,6,12,0.5,14,32,0.438,0.523,24,31,0.774,7,15,22,33,2,1,11,12,70
268,Alex Len,C,29,SAC,12,1,43,5,10,0.5,0,1,0,5,9,0.556,0.5,3,4,0.75,4,11,15,4,0,0,4,8,13
269,Kawhi Leonard,SF,31,LAC,28,26,884,224,438,0.511,44,122,0.361,180,316,0.57,0.562,117,137,0.854,35,136,171,111,37,13,44,38,609
270,Caris LeVert,SG,28,CLE,49,25,1512,219,533,0.411,82,219,0.374,137,314,0.436,0.488,91,129,0.705,36,155,191,186,38,12,80,110,611
271,Kira Lewis Jr.,PG,21,NOP,7,0,74,16,29,0.552,3,8,0.375,13,21,0.619,0.603,8,8,1,1,11,12,5,1,1,4,7,43
272,Damian Lillard,PG,32,POR,38,38,1365,351,758,0.463,156,420,0.371,195,338,0.577,0.566,298,329,0.906,22,128,150,277,33,12,119,75,1156
273,Nassir Little,SF,22,POR,29,1,472,67,136,0.493,31,68,0.456,36,68,0.529,0.607,16,26,0.615,11,54,65,25,9,8,15,27,181
274,Isaiah Livers,PF,24,DET,30,9,629,57,143,0.399,40,110,0.364,17,33,0.515,0.538,21,27,0.778,17,54,71,20,12,17,14,59,175
275,Kenneth Lofton Jr.,PF,20,MEM,7,0,29,7,17,0.412,0,3,0,7,14,0.5,0.412,3,5,0.6,1,3,4,4,0,0,2,4,17
276,Kevon Looney,C,26,GSW,50,46,1166,141,220,0.641,0,0,,141,220,0.641,0.641,56,91,0.615,151,281,432,135,25,27,24,138,338
277,Brook Lopez,C,34,MIL,50,50,1518,274,551,0.497,94,250,0.376,180,301,0.598,0.583,76,96,0.792,95,222,317,63,25,126,71,126,718
278,Robin Lopez,C,34,CLE,26,1,225,33,51,0.647,1,1,1,32,50,0.64,0.657,10,14,0.714,19,20,39,12,1,4,19,33,77
279,Kevin Love,PF,34,CLE,41,3,821,111,285,0.389,69,195,0.354,42,90,0.467,0.511,56,63,0.889,42,238,280,76,7,7,47,65,347
280,Kyle Lowry,PG,36,MIA,43,43,1440,168,420,0.4,89,265,0.336,79,155,0.51,0.506,100,117,0.855,38,151,189,230,48,17,87,119,525
281,Trey Lyles,PF,27,SAC,43,0,674,105,226,0.465,49,134,0.366,56,92,0.609,0.573,53,67,0.791,40,120,160,36,16,23,33,51,312
282,Théo Maledon,PG,21,CHO,36,1,581,65,157,0.414,21,63,0.333,44,94,0.468,0.481,49,56,0.875,9,77,86,86,27,6,35,37,200
283,Sandro Mamukelashvili,C,23,MIL,20,0,171,16,46,0.348,6,25,0.24,10,21,0.476,0.413,7,12,0.583,12,32,44,14,2,3,6,14,45
284,Terance Mann,SG,26,LAC,53,28,1208,173,345,0.501,45,125,0.36,128,220,0.582,0.567,56,74,0.757,51,140,191,110,30,16,51,91,447
285,Tre Mann,PG,21,OKC,45,4,838,136,350,0.389,56,185,0.303,80,165,0.485,0.469,20,29,0.69,18,87,105,70,30,9,43,70,348
286,Boban Marjanović,C,34,HOU,16,0,66,17,25,0.68,0,1,0,17,24,0.708,0.68,11,14,0.786,8,17,25,4,1,1,4,2,45
287,Lauri Markkanen,SF,25,UTA,47,47,1610,394,758,0.52,146,338,0.432,248,420,0.59,0.616,234,269,0.87,82,322,404,83,30,29,84,95,1168
288,Naji Marshall,SF,25,NOP,47,18,1183,166,390,0.426,48,153,0.314,118,237,0.498,0.487,96,121,0.793,36,141,177,121,37,11,63,69,476
289,Caleb Martin,PF,27,MIA,42,42,1287,161,347,0.464,58,151,0.384,103,196,0.526,0.548,45,57,0.789,56,149,205,71,43,15,48,88,425
290,Cody Martin,SF,27,CHO,7,0,134,14,36,0.389,3,14,0.214,11,22,0.5,0.431,4,7,0.571,8,16,24,11,4,1,2,13,35
291,Kenyon Martin Jr.,SF,22,HOU,50,17,1264,224,403,0.556,45,137,0.328,179,266,0.673,0.612,69,113,0.611,72,200,272,70,22,16,56,89,562
292,Tyrese Martin,SG,23,ATL,12,0,44,6,16,0.375,1,5,0.2,5,11,0.455,0.406,2,2,1,2,4,6,0,1,0,1,2,15
293,Garrison Mathews,SG,26,HOU,43,0,576,59,166,0.355,52,151,0.344,7,15,0.467,0.512,41,45,0.911,10,47,57,22,23,4,16,56,211
294,Bennedict Mathurin,SF,20,IND,52,6,1486,290,680,0.426,76,235,0.323,214,445,0.481,0.482,274,333,0.823,58,160,218,74,31,5,96,108,930
295,Wesley Matthews,SG,36,MIL,32,0,471,35,97,0.361,28,78,0.359,7,19,0.368,0.505,11,12,0.917,26,39,65,19,15,8,12,45,109
296,Tyrese Maxey,SG,22,PHI,30,22,1011,224,490,0.457,74,189,0.392,150,301,0.498,0.533,95,119,0.798,10,77,87,116,25,4,48,63,617
297,Miles McBride,PG,22,NYK,40,2,525,46,142,0.324,23,91,0.253,23,51,0.451,0.405,16,24,0.667,10,23,33,48,25,2,18,39,131
298,CJ McCollum,SG,31,NOP,46,46,1620,365,850,0.429,135,349,0.387,230,501,0.459,0.509,113,143,0.79,36,168,204,267,46,28,123,81,978
299,T.J. McConnell,PG,30,IND,49,5,964,159,303,0.525,13,30,0.433,146,273,0.535,0.546,37,41,0.902,31,109,140,251,55,5,86,59,368
300,Jaden McDaniels,PF,22,MIN,50,50,1545,226,436,0.518,62,163,0.38,164,273,0.601,0.589,59,80,0.738,65,125,190,98,50,50,74,176,573
301,Jalen McDaniels,SF,25,CHO,52,21,1402,211,467,0.452,63,191,0.33,148,276,0.536,0.519,83,99,0.838,42,215,257,105,58,28,77,152,568
302,Doug McDermott,SF,31,SAS,45,0,918,168,360,0.467,83,200,0.415,85,160,0.531,0.582,35,47,0.745,14,89,103,61,9,6,43,76,454
303,JaVale McGee,C,35,DAL,30,7,238,53,84,0.631,1,4,0.25,52,80,0.65,0.637,14,26,0.538,19,53,72,8,4,16,28,36,121
304,Bryce McGowens,SG,20,CHO,22,1,304,27,74,0.365,9,26,0.346,18,48,0.375,0.426,17,20,0.85,8,28,36,21,4,4,9,17,80
305,Rodney McGruder,SG,31,DET,20,2,213,21,56,0.375,15,40,0.375,6,16,0.375,0.509,8,11,0.727,10,17,27,14,5,0,7,15,65
306,Jordan McLaughlin,PG,26,MIN,18,0,287,28,66,0.424,8,34,0.235,20,32,0.625,0.485,9,9,1,7,23,30,65,15,2,14,7,73
307,De'Anthony Melton,PG,24,PHI,46,37,1338,185,435,0.425,105,265,0.396,80,170,0.471,0.546,35,45,0.778,46,161,207,131,87,26,69,112,510
308,Chimezie Metu,C,25,SAC,36,0,389,74,127,0.583,5,24,0.208,69,103,0.67,0.602,25,31,0.806,27,84,111,24,11,7,21,48,178
309,Khris Middleton,SF,31,MIL,12,7,253,46,124,0.371,18,60,0.3,28,64,0.438,0.444,30,32,0.938,3,29,32,49,9,2,25,26,140
310,Patty Mills,PG,34,BRK,30,1,381,63,137,0.46,38,94,0.404,25,43,0.581,0.599,18,20,0.9,6,22,28,41,11,1,17,18,182
311,Shake Milton,SG,26,PHI,45,9,1028,172,344,0.5,37,96,0.385,135,248,0.544,0.554,63,75,0.84,26,106,132,149,15,8,63,77,444
312,Josh Minott,SF,20,MIN,7,0,16,3,5,0.6,0,1,0,3,4,0.75,0.6,4,4,1,2,3,5,2,1,2,0,2,10
313,Davion Mitchell,PG,24,SAC,48,3,875,114,247,0.462,38,112,0.339,76,135,0.563,0.538,15,20,0.75,10,60,70,102,25,11,42,70,281
314,Donovan Mitchell,SG,26,CLE,43,43,1541,410,856,0.479,159,407,0.391,251,449,0.559,0.572,207,239,0.866,40,126,166,210,66,15,121,109,1186
315,Evan Mobley,PF,21,CLE,51,51,1745,320,575,0.557,12,60,0.2,308,515,0.598,0.567,127,183,0.694,121,331,452,137,36,69,106,144,779
316,Isaiah Mobley,PF,23,CLE,8,0,26,4,8,0.5,1,2,0.5,3,6,0.5,0.563,0,0,,1,10,11,0,1,0,0,2,9
317,Chima Moneke,SF,27,SAC,2,0,8,1,2,0.5,0,0,,1,2,0.5,0.5,0,2,0,2,0,2,1,0,0,2,2,2
318,Malik Monk,SG,24,SAC,48,0,1068,222,509,0.436,80,251,0.319,142,258,0.55,0.515,107,119,0.899,23,98,121,187,30,11,92,77,631
319,Moses Moody,SG,20,GSW,39,3,577,70,155,0.452,36,98,0.367,34,57,0.596,0.568,26,37,0.703,17,50,67,36,13,5,27,35,202
320,Wendell Moore Jr.,SG,21,MIN,20,2,111,13,31,0.419,2,13,0.154,11,18,0.611,0.452,4,5,0.8,2,12,14,10,5,4,7,12,32
321,Ja Morant,PG,23,MEM,42,42,1371,407,876,0.465,70,220,0.318,337,656,0.514,0.505,261,348,0.75,47,193,240,346,42,12,148,72,1145
322,Marcus Morris,PF,33,LAC,46,46,1329,219,501,0.437,92,243,0.379,127,258,0.492,0.529,62,78,0.795,22,181,203,83,28,19,42,102,592
323,Markieff Morris,PF,33,BRK,25,1,272,33,80,0.413,20,48,0.417,13,32,0.406,0.538,10,10,1,13,42,55,24,7,5,13,32,96
324,Monte Morris,PG,27,WAS,43,43,1219,170,359,0.474,58,146,0.397,112,213,0.526,0.554,48,59,0.814,17,126,143,227,31,8,38,61,446
325,Trey Murphy III,SF,22,NOP,49,39,1428,214,446,0.48,105,266,0.395,109,180,0.606,0.598,84,91,0.923,39,141,180,64,52,26,38,97,617
326,Dejounte Murray,SG,26,ATL,46,46,1686,391,846,0.462,94,258,0.364,297,588,0.505,0.518,100,117,0.855,34,218,252,280,76,15,106,67,976
327,Jamal Murray,PG,25,DEN,43,43,1397,304,671,0.453,98,250,0.392,206,421,0.489,0.526,130,156,0.833,34,142,176,246,41,9,92,57,836
328,Keegan Murray,SF,22,SAC,47,45,1398,207,458,0.452,119,282,0.422,88,176,0.5,0.582,46,57,0.807,54,155,209,45,35,25,42,98,579
329,Mike Muscala,C,31,OKC,39,4,560,74,175,0.423,46,121,0.38,28,54,0.519,0.554,30,37,0.811,20,99,119,33,10,18,14,66,224
330,Svi Mykhailiuk,SF,25,NYK,13,0,40,6,12,0.5,6,10,0.6,0,2,0,0.75,3,5,0.6,0,7,7,1,1,0,2,1,21
331,Larry Nance Jr.,PF,30,NOP,42,0,949,140,228,0.614,12,33,0.364,128,195,0.656,0.64,38,54,0.704,72,170,242,79,41,30,33,97,330
332,Andrew Nembhard,SG,23,IND,45,34,1221,151,353,0.428,57,166,0.343,94,187,0.503,0.508,24,27,0.889,25,107,132,181,45,9,80,124,383
333,Aaron Nesmith,SF,23,IND,45,33,1062,142,350,0.406,62,182,0.341,80,168,0.476,0.494,73,83,0.88,36,131,167,51,35,19,43,151,419
334,Raul Neto,PG,30,CLE,33,0,341,37,69,0.536,10,30,0.333,27,39,0.692,0.609,18,20,0.9,6,25,31,46,12,3,12,27,102
335,Georges Niang,PF,29,PHI,47,0,931,149,328,0.454,108,255,0.424,41,73,0.562,0.619,25,27,0.926,13,102,115,54,17,10,36,89,431
336,Daishen Nix,PG,20,HOU,37,2,539,41,117,0.35,27,79,0.342,14,38,0.368,0.466,20,29,0.69,11,44,55,90,25,3,53,34,129
337,Zeke Nnaji,PF,22,DEN,41,5,529,80,141,0.567,12,41,0.293,68,100,0.68,0.61,32,49,0.653,52,41,93,11,12,16,17,72,204
338,Nerlens Noel,C,28,DET,13,3,148,12,28,0.429,1,2,0.5,11,26,0.423,0.446,7,10,0.7,7,29,36,7,13,9,8,24,32
339,Jaylen Nowell,SG,23,MIN,53,1,1047,230,522,0.441,54,195,0.277,176,327,0.538,0.492,66,86,0.767,30,109,139,110,37,4,54,83,580
340,Frank Ntilikina,PG,24,DAL,30,2,379,31,85,0.365,10,45,0.222,21,40,0.525,0.424,12,18,0.667,4,37,41,36,7,3,23,44,84
341,Kendrick Nunn,SG-PG,27,TOT,42,2,588,117,284,0.412,46,141,0.326,71,143,0.497,0.493,18,22,0.818,8,56,64,40,14,3,32,39,298
341,Kendrick Nunn,SG,27,LAL,39,2,528,102,251,0.406,41,126,0.325,61,125,0.488,0.488,17,21,0.81,5,50,55,34,11,3,31,35,262
341,Kendrick Nunn,PG,27,WAS,3,0,60,15,33,0.455,5,15,0.333,10,18,0.556,0.53,1,1,1,3,6,9,6,3,0,1,4,36
342,Jusuf Nurkić,C,28,POR,44,44,1224,232,442,0.525,39,99,0.394,193,343,0.563,0.569,116,169,0.686,103,321,424,129,39,39,109,161,619
343,Jordan Nwora,SF,24,MIL,38,3,597,76,197,0.386,40,102,0.392,36,95,0.379,0.487,37,43,0.86,29,88,117,38,12,7,34,34,229
344,Royce O'Neale,SF,29,BRK,47,47,1627,155,389,0.398,107,265,0.404,48,124,0.387,0.536,28,40,0.7,35,196,231,187,42,34,80,147,445
345,Chuma Okeke,SF,24,ORL,18,7,392,32,87,0.368,18,60,0.3,14,27,0.519,0.471,16,21,0.762,21,55,76,26,11,9,9,34,98
346,Josh Okogie,SG,24,PHO,45,1,585,72,185,0.389,22,77,0.286,50,108,0.463,0.449,62,88,0.705,64,73,137,52,25,20,39,62,228
347,Onyeka Okongwu,C,22,ATL,49,17,1205,188,296,0.635,0,3,0,188,293,0.642,0.635,73,100,0.73,132,234,366,49,32,61,50,159,449
348,Isaac Okoro,SF,22,CLE,53,23,1073,111,234,0.474,37,111,0.333,74,123,0.602,0.553,52,71,0.732,36,101,137,53,38,23,32,107,311
349,KZ Okpala,PF,23,SAC,35,3,248,16,38,0.421,7,21,0.333,9,17,0.529,0.513,7,8,0.875,7,27,34,13,7,7,7,39,46
350,Victor Oladipo,SG,30,MIA,26,1,739,105,260,0.404,37,125,0.296,68,135,0.504,0.475,43,57,0.754,13,77,90,101,43,6,48,63,290
351,Kelly Olynyk,C,31,UTA,40,40,1127,158,316,0.5,58,140,0.414,100,176,0.568,0.592,103,124,0.831,44,151,195,129,43,25,91,159,477
352,Eugene Omoruyi,SF,25,OKC,20,2,248,41,85,0.482,8,29,0.276,33,56,0.589,0.529,13,21,0.619,19,27,46,11,13,0,14,42,103
353,Cedi Osman,SF,27,CLE,51,0,1076,171,361,0.474,71,199,0.357,100,162,0.617,0.572,50,74,0.676,14,99,113,73,25,5,38,83,463
354,Kelly Oubre Jr.,SF,27,CHO,35,30,1141,263,624,0.421,80,260,0.308,183,364,0.503,0.486,100,140,0.714,52,127,179,42,55,13,44,104,706
355,Chris Paul,PG,37,PHO,31,31,986,154,342,0.45,57,138,0.413,97,204,0.475,0.534,83,100,0.83,13,123,136,269,43,12,63,73,448
356,Cameron Payne,PG,28,PHO,28,14,671,127,308,0.412,48,127,0.378,79,181,0.436,0.49,38,49,0.776,9,55,64,148,25,5,55,57,340
357,Gary Payton II,PG,30,POR,11,0,175,17,28,0.607,7,11,0.636,10,17,0.588,0.732,0,0,,7,23,30,21,12,0,9,19,41
358,Theo Pinson,SG,27,DAL,25,0,132,12,34,0.353,9,24,0.375,3,10,0.3,0.485,8,9,0.889,3,25,28,13,2,0,4,9,41
359,Scotty Pippen Jr.,PG,22,LAL,6,0,32,4,12,0.333,1,3,0.333,3,9,0.333,0.375,5,9,0.556,2,2,4,2,2,1,2,3,14
360,Mason Plumlee,C,32,CHO,52,52,1472,247,368,0.671,0,0,,247,368,0.671,0.671,142,233,0.609,176,334,510,188,32,34,81,148,636
361,Jakob Poeltl,C,27,SAS,42,42,1089,212,342,0.62,0,0,,212,342,0.62,0.62,72,122,0.59,138,240,378,126,33,49,83,107,496
362,Aleksej Pokusevski,PF,21,OKC,31,25,677,107,243,0.44,38,101,0.376,69,142,0.486,0.519,21,33,0.636,45,112,157,62,20,41,41,57,273
363,Jordan Poole,PG,23,GSW,50,28,1530,354,810,0.437,128,398,0.322,226,412,0.549,0.516,206,239,0.862,20,115,135,217,45,12,171,130,1042
364,Kevin Porter Jr.,PG,22,HOU,40,40,1359,269,615,0.437,88,254,0.346,181,361,0.501,0.509,141,184,0.766,55,163,218,225,53,16,143,109,767
365,Michael Porter Jr.,SF,24,DEN,34,34,983,204,426,0.479,94,228,0.412,110,198,0.556,0.589,48,62,0.774,34,160,194,36,21,16,38,80,550
366,Otto Porter Jr.,SF,29,TOR,8,2,146,15,30,0.5,6,17,0.353,9,13,0.692,0.6,8,8,1,6,13,19,8,11,0,4,7,44
367,Bobby Portis,PF,27,MIL,47,14,1258,281,563,0.499,58,170,0.341,223,393,0.567,0.551,58,70,0.829,120,353,473,85,22,11,59,81,678
368,Kristaps Porziņģis,C,27,WAS,42,42,1369,302,643,0.47,79,227,0.348,223,416,0.536,0.531,239,289,0.827,83,285,368,104,41,66,92,127,922
369,Micah Potter,PF,24,UTA,3,0,14,2,2,1,0,0,,2,2,1,1,0,0,,1,2,3,2,0,0,0,2,4
370,Dwight Powell,C,31,DAL,47,35,899,115,162,0.71,0,3,0,115,159,0.723,0.71,76,107,0.71,93,94,187,33,27,20,40,131,306
371,Norman Powell,SG,29,LAC,44,7,1118,241,498,0.484,88,207,0.425,153,291,0.526,0.572,153,192,0.797,15,116,131,75,33,16,74,88,723
372,Jason Preston,PG,23,LAC,12,0,118,17,40,0.425,5,18,0.278,12,22,0.545,0.488,0,2,0,2,20,22,27,2,0,9,7,39
373,Joshua Primo,SG,20,SAS,4,0,93,9,26,0.346,3,12,0.25,6,14,0.429,0.404,7,9,0.778,2,11,13,18,1,2,11,8,28
374,Taurean Prince,SF,28,MIN,29,0,610,92,183,0.503,40,95,0.421,52,88,0.591,0.612,27,33,0.818,8,60,68,39,13,9,32,71,251
375,Payton Pritchard,PG,25,BOS,35,2,439,65,162,0.401,32,97,0.33,33,65,0.508,0.5,8,12,0.667,19,37,56,37,12,1,26,25,170
376,Trevelin Queen,SG,25,IND,7,0,70,7,29,0.241,2,15,0.133,5,14,0.357,0.276,5,5,1,8,9,17,6,2,5,7,4,21
377,Neemias Queta,C,23,SAC,4,0,25,6,8,0.75,0,0,,6,8,0.75,0.75,0,2,0,4,5,9,1,0,1,1,7,12
378,Immanuel Quickley,PG,23,NYK,51,8,1408,227,520,0.437,84,244,0.344,143,276,0.518,0.517,111,132,0.841,35,172,207,165,44,6,60,109,649
379,Julius Randle,PF,28,NYK,52,52,1866,431,941,0.458,139,408,0.341,292,533,0.548,0.532,283,378,0.749,120,445,565,211,35,17,143,163,1284
380,Austin Reaves,SG,24,LAL,36,12,1039,124,254,0.488,45,125,0.36,79,129,0.612,0.577,95,106,0.896,23,88,111,80,20,14,49,60,388
381,Cam Reddish,SF,23,NYK,20,8,438,61,136,0.449,17,56,0.304,44,80,0.55,0.511,29,33,0.879,7,24,31,20,15,8,15,32,168
382,Davon Reed,SG,27,DEN,31,1,278,22,69,0.319,15,41,0.366,7,28,0.25,0.428,13,18,0.722,8,41,49,16,8,4,15,30,72
383,Paul Reed,C,23,PHI,37,0,359,51,90,0.567,0,4,0,51,86,0.593,0.567,15,20,0.75,50,74,124,14,25,23,22,72,117
384,Naz Reid,C,23,MIN,45,7,792,181,336,0.539,40,125,0.32,141,211,0.668,0.598,51,75,0.68,53,159,212,40,27,42,57,106,453
385,Jared Rhoden,SG,23,DET,1,0,12,1,3,0.333,0,1,0,1,2,0.5,0.333,0,0,,0,1,1,0,0,0,0,3,2
386,Nick Richards,C,25,CHO,40,0,680,123,197,0.624,0,0,,123,197,0.624,0.624,79,109,0.725,101,122,223,21,9,35,33,88,325
387,Josh Richardson,SG,29,SAS,38,3,880,156,355,0.439,67,185,0.362,89,170,0.524,0.534,48,55,0.873,26,77,103,121,31,8,55,61,427
388,Austin Rivers,SG,30,MIN,41,10,870,81,175,0.463,37,102,0.363,44,73,0.603,0.569,26,31,0.839,3,70,73,62,25,2,22,69,225
389,Duncan Robinson,SF,28,MIA,28,0,501,64,174,0.368,46,139,0.331,18,35,0.514,0.5,20,22,0.909,7,47,54,33,8,0,19,56,194
390,Mitchell Robinson,C,24,NYK,38,37,1022,118,175,0.674,0,0,,118,175,0.674,0.674,39,77,0.506,165,173,338,37,34,68,18,111,275
391,Orlando Robinson,C,22,MIA,24,1,345,41,78,0.526,0,5,0,41,73,0.562,0.526,20,27,0.741,37,64,101,19,12,11,13,44,102
392,Jeremiah Robinson-Earl,PF,22,OKC,26,18,548,85,174,0.489,29,76,0.382,56,98,0.571,0.572,22,28,0.786,51,78,129,25,19,11,16,49,221
393,Isaiah Roby,PF,24,SAS,35,1,371,54,122,0.443,16,49,0.327,38,73,0.521,0.508,16,36,0.444,17,70,87,33,13,6,19,38,140
394,David Roddy,PF,21,MEM,43,1,779,104,253,0.411,37,130,0.285,67,123,0.545,0.484,27,45,0.6,27,89,116,29,20,12,39,65,272
395,Ryan Rollins,PG,20,GSW,12,0,62,7,20,0.35,3,9,0.333,4,11,0.364,0.425,6,6,1,3,9,12,6,1,1,16,10,23
396,Derrick Rose,PG,34,NYK,26,0,336,61,155,0.394,19,60,0.317,42,95,0.442,0.455,11,12,0.917,8,32,40,46,7,5,22,18,152
397,Terrence Ross,SG,31,ORL,42,9,944,129,299,0.431,61,160,0.381,68,139,0.489,0.533,15,20,0.75,10,75,85,54,25,8,37,53,334
398,Terry Rozier,SG,28,CHO,42,42,1501,339,819,0.414,115,342,0.336,224,477,0.47,0.484,117,141,0.83,39,140,179,214,41,10,96,78,910
399,Ricky Rubio,PG,32,CLE,9,0,138,15,48,0.313,9,28,0.321,6,20,0.3,0.406,4,8,0.5,2,22,24,29,6,0,5,14,43
400,D'Angelo Russell,PG,26,MIN,50,50,1656,308,668,0.461,130,337,0.386,178,331,0.538,0.558,135,158,0.854,26,124,150,313,56,20,135,108,881
401,Matt Ryan,SF,25,TOT,28,0,247,30,87,0.345,25,66,0.379,5,21,0.238,0.489,8,9,0.889,4,19,23,10,4,1,6,20,93
401,Matt Ryan,SF,25,LAL,12,0,129,15,49,0.306,13,35,0.371,2,14,0.143,0.439,4,5,0.8,2,12,14,4,2,0,3,14,47
401,Matt Ryan,SF,25,MIN,16,0,118,15,38,0.395,12,31,0.387,3,7,0.429,0.553,4,4,1,2,7,9,6,2,1,3,6,46
402,Domantas Sabonis,C,26,SAC,47,47,1622,325,533,0.61,20,55,0.364,305,478,0.638,0.629,200,267,0.749,139,442,581,335,35,22,139,171,870
403,Dario Šarić,PF,28,PHO,33,11,455,64,148,0.432,23,59,0.39,41,89,0.461,0.51,33,40,0.825,35,86,121,48,12,4,32,60,184
404,Jordan Schakel,SF,24,WAS,2,0,6,1,2,0.5,1,1,1,0,1,0,0.75,0,0,,0,0,0,1,1,0,0,1,3
405,Admiral Schofield,PF,25,ORL,27,0,350,44,92,0.478,18,54,0.333,26,38,0.684,0.576,17,19,0.895,19,33,52,23,6,3,6,52,123
406,Dennis Schröder,PG,29,LAL,38,35,1160,151,366,0.413,46,135,0.341,105,231,0.455,0.475,117,132,0.886,11,89,100,148,29,5,60,87,465
407,Dereon Seabron,SG,22,NOP,4,0,8,2,4,0.5,0,0,,2,4,0.5,0.5,0,0,,1,0,1,0,0,0,0,1,4
408,Alperen Şengün,C,20,HOU,45,42,1261,276,480,0.575,10,32,0.313,266,448,0.594,0.585,134,181,0.74,147,255,402,161,38,46,110,151,696
409,Collin Sexton,SG,24,UTA,39,10,933,191,383,0.499,41,98,0.418,150,285,0.526,0.552,136,164,0.829,32,55,87,107,23,4,68,93,559
410,Landry Shamet,SG,25,PHO,30,7,642,92,242,0.38,61,162,0.377,31,80,0.388,0.506,41,45,0.911,8,43,51,67,18,5,29,46,286
411,Day'Ron Sharpe,C,21,BRK,25,1,228,37,71,0.521,4,5,0.8,33,66,0.5,0.549,14,21,0.667,38,49,87,19,4,15,19,42,92
412,Shaedon Sharpe,SG,19,POR,49,5,972,152,322,0.472,43,128,0.336,109,194,0.562,0.539,28,44,0.636,36,84,120,25,17,10,35,81,375
413,Pascal Siakam,C,28,TOR,42,42,1582,371,787,0.471,55,175,0.314,316,612,0.516,0.506,251,325,0.772,80,255,335,263,31,25,108,140,1048
414,Ben Simmons,PG,26,BRK,37,32,1009,124,219,0.566,0,1,0,124,218,0.569,0.566,25,56,0.446,36,205,241,237,53,21,88,127,273
415,Marko Simonovic,C,23,CHI,2,0,3,0,1,0,0,1,0,0,0,,0,0,0,,0,0,0,0,0,0,0,0,0
416,Anfernee Simons,SG,23,POR,48,48,1722,369,822,0.449,172,456,0.377,197,366,0.538,0.554,126,140,0.9,13,120,133,194,33,12,107,119,1036
417,Jericho Sims,C,24,NYK,39,8,578,70,86,0.814,0,0,,70,86,0.814,0.814,8,10,0.8,75,110,185,17,10,25,18,68,148
418,Marcus Smart,PG,28,BOS,41,41,1330,164,389,0.422,73,219,0.333,91,170,0.535,0.515,56,73,0.767,30,110,140,294,53,17,97,109,457
419,Dennis Smith Jr.,PG,25,CHO,30,11,759,97,243,0.399,11,56,0.196,86,187,0.46,0.422,30,40,0.75,14,71,85,141,41,12,43,72,235
420,Dru Smith,SG,25,MIA,5,1,67,5,14,0.357,1,6,0.167,4,8,0.5,0.393,0,0,,1,8,9,5,4,3,1,10,11
421,Ish Smith,PG,34,DEN,22,0,186,26,62,0.419,2,6,0.333,24,56,0.429,0.435,1,2,0.5,1,16,17,37,6,6,22,13,55
422,Jabari Smith Jr.,PF,19,HOU,47,47,1389,198,512,0.387,77,256,0.301,121,256,0.473,0.462,84,108,0.778,56,273,329,49,26,47,64,143,557
423,Jalen Smith,PF,22,IND,47,28,899,168,363,0.463,41,146,0.281,127,217,0.585,0.519,75,98,0.765,84,188,272,48,17,38,56,107,452
424,Jeremy Sochan,PF,19,SAS,44,41,1155,181,392,0.462,26,96,0.271,155,296,0.524,0.495,57,84,0.679,75,142,217,112,34,19,77,117,445
425,Jaden Springer,SG,20,PHI,7,0,26,7,12,0.583,0,0,,7,12,0.583,0.583,3,4,0.75,4,3,7,1,2,2,1,7,17
426,Lamar Stevens,PF,25,CLE,36,18,697,79,175,0.451,18,57,0.316,61,118,0.517,0.503,25,36,0.694,23,94,117,21,14,14,19,51,201
427,Isaiah Stewart,C,21,DET,41,38,1151,159,355,0.448,52,160,0.325,107,195,0.549,0.521,93,125,0.744,97,225,322,50,17,29,58,112,463
428,Max Strus,SF,26,MIA,50,25,1498,218,546,0.399,128,379,0.338,90,167,0.539,0.516,56,63,0.889,35,147,182,108,35,9,50,101,620
429,Jalen Suggs,PG,21,ORL,27,13,612,87,214,0.407,28,102,0.275,59,112,0.527,0.472,43,62,0.694,24,50,74,102,30,12,55,66,245
430,Edmond Sumner,SG,27,BRK,42,10,568,93,202,0.46,22,65,0.338,71,137,0.518,0.515,72,78,0.923,10,53,63,58,27,7,39,66,280
431,Cole Swider,SF,23,LAL,5,0,37,3,9,0.333,3,8,0.375,0,1,0,0.5,0,0,,1,6,7,4,0,0,0,3,9
432,Jae'Sean Tate,SF,27,HOU,13,2,269,39,86,0.453,6,19,0.316,33,67,0.493,0.488,16,20,0.8,21,30,51,40,10,2,22,44,100
433,Jayson Tatum,PF,24,BOS,48,48,1798,485,1044,0.465,157,448,0.35,328,596,0.55,0.54,366,421,0.869,53,366,419,212,51,36,138,105,1493
434,Terry Taylor,PF,23,IND,25,2,223,29,64,0.453,4,18,0.222,25,46,0.543,0.484,5,7,0.714,22,17,39,9,3,5,9,23,67
435,Garrett Temple,SG,36,NOP,16,0,121,14,34,0.412,8,20,0.4,6,14,0.429,0.529,3,4,0.75,2,9,11,9,9,1,3,14,39
436,Dalen Terry,SG,20,CHI,18,0,56,6,16,0.375,1,4,0.25,5,12,0.417,0.406,3,4,0.75,1,5,6,7,1,2,4,4,16
437,Cam Thomas,SG,21,BRK,33,0,455,80,183,0.437,17,44,0.386,63,139,0.453,0.484,54,69,0.783,3,41,44,41,12,4,26,29,231
438,Klay Thompson,SG,32,GSW,39,39,1266,299,713,0.419,160,406,0.394,139,307,0.453,0.532,66,74,0.892,28,127,155,95,25,16,65,84,824
439,JT Thor,PF,20,CHO,39,0,430,37,102,0.363,13,53,0.245,24,49,0.49,0.426,17,23,0.739,19,50,69,15,9,9,18,32,104
440,Matisse Thybulle,SG,25,PHI,45,6,545,47,108,0.435,20,60,0.333,27,48,0.563,0.528,7,10,0.7,16,39,55,22,41,14,7,60,121
441,Xavier Tillman Sr.,PF,24,MEM,31,2,389,63,105,0.6,3,10,0.3,60,95,0.632,0.614,19,37,0.514,54,55,109,24,21,10,13,31,148
442,Isaiah Todd,PF,21,WAS,4,0,13,1,4,0.25,0,3,0,1,1,1,0.25,0,0,,0,0,0,0,0,0,0,0,2
443,Obi Toppin,PF,24,NYK,37,0,566,92,217,0.424,46,123,0.374,46,94,0.489,0.53,19,23,0.826,18,105,123,33,14,6,21,37,249
444,Juan Toscano-Anderson,SF,29,LAL,30,7,365,33,66,0.5,4,20,0.2,29,46,0.63,0.53,11,15,0.733,14,47,61,25,10,7,17,46,81
445,Karl-Anthony Towns,PF,27,MIN,21,21,709,153,303,0.505,38,117,0.325,115,186,0.618,0.568,92,104,0.885,35,137,172,111,16,14,65,82,436
446,Gary Trent Jr.,SG,24,TOR,45,35,1496,293,660,0.444,120,327,0.367,173,333,0.52,0.535,133,160,0.831,19,94,113,69,75,13,42,78,839
447,P.J. Tucker,PF,37,PHI,47,47,1243,53,133,0.398,29,76,0.382,24,57,0.421,0.508,16,18,0.889,61,129,190,40,24,12,33,117,151
448,Myles Turner,C,26,IND,43,43,1287,271,498,0.544,68,173,0.393,203,325,0.625,0.612,141,185,0.762,64,271,335,58,25,102,69,138,751
449,Jonas Valančiūnas,C,30,NOP,52,52,1282,297,553,0.537,31,88,0.352,266,465,0.572,0.565,128,156,0.821,141,357,498,83,15,27,105,161,753
450,Jarred Vanderbilt,PF,23,UTA,50,41,1218,170,305,0.557,19,55,0.345,151,250,0.604,0.589,67,100,0.67,119,275,394,139,52,14,68,128,426
451,Fred VanVleet,PG,28,TOR,43,43,1590,270,684,0.395,126,369,0.341,144,315,0.457,0.487,160,178,0.899,21,164,185,280,69,26,77,127,826
452,Devin Vassell,SG,22,SAS,29,24,907,206,463,0.445,82,203,0.404,124,260,0.477,0.533,69,87,0.793,6,109,115,104,35,12,45,42,563
453,Gabe Vincent,PG,26,MIA,38,5,941,128,316,0.405,63,190,0.332,65,126,0.516,0.505,40,46,0.87,14,68,82,98,31,3,53,90,359
454,Noah Vonleh,C,27,BOS,23,1,171,11,24,0.458,1,4,0.25,10,20,0.5,0.479,2,2,1,18,30,48,7,2,8,11,35,25
455,Nikola Vučević,C,32,CHI,50,50,1700,358,686,0.522,85,230,0.37,273,456,0.599,0.584,80,96,0.833,106,451,557,166,34,43,90,108,881
456,Dean Wade,PF,26,CLE,23,9,521,49,108,0.454,30,75,0.4,19,33,0.576,0.593,13,21,0.619,11,73,84,23,16,10,11,53,141
457,Franz Wagner,SF,21,ORL,50,50,1656,361,735,0.491,85,228,0.373,276,507,0.544,0.549,188,223,0.843,45,156,201,175,45,10,101,110,995
458,Moritz Wagner,C,25,ORL,30,14,652,114,228,0.5,31,97,0.32,83,131,0.634,0.568,86,98,0.878,45,115,160,53,22,6,42,87,345
459,Ish Wainright,SF,28,PHO,34,1,490,46,118,0.39,30,86,0.349,16,32,0.5,0.517,6,9,0.667,30,38,68,36,26,8,15,67,128
460,Jabari Walker,SF,20,POR,31,0,270,25,62,0.403,3,16,0.188,22,46,0.478,0.427,14,21,0.667,28,40,68,16,3,5,11,34,67
461,Kemba Walker,PG,32,DAL,9,1,144,24,57,0.421,7,28,0.25,17,29,0.586,0.482,17,21,0.81,3,13,16,19,2,2,4,11,72
462,Lonnie Walker IV,SG,24,LAL,35,32,1007,181,397,0.456,69,183,0.377,112,214,0.523,0.543,66,75,0.88,11,69,80,46,25,12,34,57,497
463,John Wall,PG,32,LAC,34,3,755,138,338,0.408,33,109,0.303,105,229,0.459,0.457,77,113,0.681,14,78,92,178,27,12,80,59,386
464,T.J. Warren,PF,29,BRK,24,0,456,92,184,0.5,15,45,0.333,77,139,0.554,0.541,23,29,0.793,13,56,69,29,15,7,16,41,222
465,Duane Washington Jr.,SG,22,PHO,31,3,394,94,256,0.367,40,111,0.36,54,145,0.372,0.445,16,24,0.667,2,34,36,63,6,4,34,23,244
466,P.J. Washington,PF,24,CHO,51,51,1659,288,652,0.442,102,288,0.354,186,364,0.511,0.52,91,117,0.778,54,180,234,124,47,54,74,140,769
467,TyTy Washington Jr.,PG,21,HOU,17,0,200,23,68,0.338,5,33,0.152,18,35,0.514,0.375,4,8,0.5,1,21,22,22,8,0,9,20,55
468,Yuta Watanabe,SF,28,BRK,37,0,675,92,173,0.532,47,96,0.49,45,77,0.584,0.668,23,33,0.697,26,74,100,31,17,14,15,55,254
469,Lindy Waters III,SG,25,OKC,19,0,214,26,67,0.388,23,62,0.371,3,5,0.6,0.56,5,7,0.714,7,24,31,15,6,6,5,19,80
470,Trendon Watford,PF,22,POR,34,2,510,59,104,0.567,8,24,0.333,51,80,0.638,0.606,38,50,0.76,21,91,112,47,13,4,28,55,164
471,Peyton Watson,SG,20,DEN,6,0,15,3,9,0.333,0,1,0,3,8,0.375,0.333,0,0,,2,1,3,0,0,0,0,1,6
472,Blake Wesley,SG,19,SAS,7,0,72,11,23,0.478,3,7,0.429,8,16,0.5,0.543,4,8,0.5,2,6,8,7,1,1,7,12,29
473,Russell Westbrook,PG,34,LAL,49,3,1408,286,683,0.419,57,198,0.288,229,485,0.472,0.46,146,222,0.658,56,254,310,369,51,22,172,117,775
474,Coby White,SG,22,CHI,42,0,889,122,298,0.409,69,191,0.361,53,107,0.495,0.525,30,38,0.789,8,104,112,79,33,4,36,72,343
475,Derrick White,SG,28,BOS,51,43,1348,177,401,0.441,80,214,0.374,97,187,0.519,0.541,91,106,0.858,29,127,156,175,38,48,52,115,525
476,Jack White,SF,25,DEN,11,0,34,3,9,0.333,1,3,0.333,2,6,0.333,0.389,0,0,,3,4,7,0,1,2,1,5,7
477,Joe Wieskamp,SF,23,TOR,2,0,17,3,5,0.6,3,4,0.75,0,1,0,0.9,0,0,,0,0,0,1,0,0,1,0,9
478,Aaron Wiggins,SG,24,OKC,39,9,716,94,188,0.5,27,68,0.397,67,120,0.558,0.572,34,42,0.81,42,89,131,58,19,6,35,64,249
479,Andrew Wiggins,SF,27,GSW,30,30,957,204,432,0.472,78,197,0.396,126,235,0.536,0.563,36,59,0.61,46,98,144,66,40,27,38,87,522
480,Alondes Williams,SG,23,BRK,1,0,5,0,0,,0,0,,0,0,,,0,0,,0,1,1,0,0,0,2,1,0
481,Grant Williams,PF,24,BOS,50,18,1390,152,316,0.481,77,183,0.421,75,133,0.564,0.603,67,79,0.848,56,180,236,83,32,20,56,129,448
482,Jalen Williams,SG,21,OKC,46,33,1320,226,440,0.514,38,122,0.311,188,318,0.591,0.557,65,87,0.747,35,145,180,128,49,24,71,120,555
483,Jaylin Williams,PF,20,OKC,18,7,245,32,71,0.451,9,21,0.429,23,50,0.46,0.514,6,11,0.545,14,59,73,23,6,1,14,35,79
484,Kenrich Williams,PF,28,OKC,42,8,936,133,256,0.52,41,101,0.406,92,155,0.594,0.6,13,30,0.433,79,131,210,79,29,12,20,83,320
485,Mark Williams,C,21,CHO,21,0,297,57,93,0.613,0,0,,57,93,0.613,0.613,34,45,0.756,32,79,111,6,16,18,15,39,148
486,Patrick Williams,PF,21,CHI,50,49,1470,193,415,0.465,74,180,0.411,119,235,0.506,0.554,58,65,0.892,48,170,218,66,36,43,66,103,518
487,Robert Williams,C,25,BOS,17,8,392,61,80,0.763,0,0,,61,80,0.763,0.763,12,18,0.667,53,84,137,28,9,21,16,26,134
488,Vince Williams Jr.,SG,22,MEM,9,0,49,3,13,0.231,1,9,0.111,2,4,0.5,0.269,0,0,,2,5,7,3,4,1,1,6,7
489,Ziaire Williams,SF,21,MEM,24,3,451,63,150,0.42,19,76,0.25,44,74,0.595,0.483,13,17,0.765,10,56,66,22,12,5,28,49,158
490,Zion Williamson,PF,22,NOP,29,29,956,285,469,0.608,7,19,0.368,278,450,0.618,0.615,177,248,0.714,58,144,202,133,32,16,99,65,754
